add	t+
adopt	t+
ask	t+
attend	t+
be	0
bear	t+
begin	0
borrow	t+
break	t-
build	t+
buy	t+
call	t+
carry	t-
catch	t+
collect	t+
combine	t+
come	t+
contain	0
cost	t+
cover	t+
crack	t-
cut	t-
decrease	t+
defeat	t-
do	t+
drink	t-
drive	t+
dye	t+
earn	t+
eat	t-
end	t+
feed	t-
fill	t+
find	t+
finish	t+
fix	t-
found	0
gather	t+
gave	t-
get	t+
give	t-
go	t+
grew	0
grow	t+
had	0
harvest	t-
has	0
have	0
hike	t+
hold	t+
immigrate	t+
include	0
increase	t+
Joan	t-
jog	t+
land	t+
leak	t+
leave	t-
list	t+
live	t+
load	t-
lose	t+
lost	t-
make	t+
measure	t+
miss	t+
move	t+
need	t-
order	t-
own	0
pave	t+
pay	t-
pick	t-
place	t-
placed	t+
plant	t-
play	t+
played	0
pour	t-
produce	t+
purchase	t+
put	t-
rain	t+
read	t+
receive	t+
record	t+
remain	0
rent	t-
rent	t+
repave	t+
require	t+
result	t+
return	t-
ride	t+
run	t+
save	t-
saw	t+
score	t+
see	t+
sell	t-
serve	t-
served	0
shop	t+
snow	t+
sold	t+
sow	t-
spend	t-
spent	t-
spill	t+
split	t-
sprint	t+
sprint	t-
stack	t-
stand	t-
start	t+
store	t+
take	t+
tear	t-
took	t-
transfer	t-
travel	t+
use	t+
use	t-
used	t-
walk	t+
want	t-
weigh	t+
went	0
were	0
win	t+
work	t+
