add	t+
adopt	t-
ask	t+
attend	t-
be	0
bear	t+
begin	0
borrow	t+
borrow	t-
break	t-
build	t+
buy	t+
buy	t-
call	t+
carry	t+
catch	t+
collect	t+
collect	t-
combine	t+
come	t+
contain	0
cost	t+
cover	t+
crack	t+
cut	t+
decrease	t+
defeat	t+
do	t+
drink	t+
drive	t+
dye	t+
earn	t-
eat	t-
end	t+
feed	t+
fill	t-
fill	t+
find	t+
finish	t+
fix	t+
gather	t+
get	t-
get	t+
give	t+
go	t+
grow	t-
grow	t+
harvest	t-
have	0
hike	t+
hold	t+
immigrate	t+
include	0
increase	t+
Joan	t-
jog	t-
land	t+
leak	t+
leave	t+
list	t-
live	t+
load	t+
lose	t+
make	t+
make	t-
measure	t+
miss	t-
move	t+
need	t-
order	t+
own	0
pave	t+
pay	t-
pay	t+
pick	t+
place	t+
plant	t+
play	t+
pour	t-
pour	t+
produce	t+
purchase	t+
put	t+
rain	t+
read	t+
receive	t-
record	t+
remain	0
rent	t-
repave	t-
require	t-
result	t+
return	t+
ride	t+
run	t+
save	t+
saw	t-
score	t+
see	t+
sell	t+
serve	t+
shop	t-
snow	t+
sow	t+
spend	t+
spill	t+
split	t-
sprint	t+
stack	t+
stand	t+
start	t+
store	t+
take	t+
tear	t+
transfer	t+
travel	t+
use	t-
walk	t+
walk	t-
want	t-
weigh	t+
win	t-
work	t-